NO texture/dirt.xpm
SO texture/gold_ore.xpm
WE texture/iron_ore.xpm
EA texture/diamond_ore.xpm

F 255,192,203
C 000,153,255

        1111111111111111111111111111111111111
        10000000001100000000S0001
        1011000001110001000000001
        1001000000000000100000001
        1111111111111111111111111
111111111011000001110000000000001
100000000011000001110111110111111
11110111111111011100000010001
11111111111111111111111111011
11111111111111111111111111011
11110111111111011101010010001
11000000110101011100000010001
10000000000000001100000010001
10000000000000001101010010001
11000001110101011111011110001
11110111 1110101 101111010001
11111111 1111111 111111111111
