NO texture/greystone.xpm
SO texture/mossy.xpm
WE texture/redbrick.xpm
EA texture/wood.xpm

F 255,192,203
C 000,153,255

        1111111111111111111111111111111111111
        1000000000110000000000001
        10110000011100010000S0001
        1001000000000000100000001
        1111111111111111110111111
111111111011     1110000000000001
100000000011     1110111110111111
11110111111111111100000010001
11111111111111111111111111011
11111111111111111111111111011
11110111111111011101010010001
11000000110101011100000010001
10000000000000001100000010001
10000000000000001101010010001
11000001110101011111011110001
11110111 1110101 101111010001
11111111 1111111 111111111111
