NO texture/dirt.xpm
SO texture/gold_ore.xpm
WE texture/iron_ore.xpm
EA texture/diamond_ore.xpm
F 255,192,203
C 225,30,0
111111
100001
100001
10S001
111111
