NO texture/greystone.xpm
SO texture/greystone.xpm
WE texture/redbrick.xpm
EA texture/wood.xpm
F 255,192,0
C 225,30,0
111111
100001
100N001
100001
111111
