NO texture/wood.xpm
SO texture/mossy.xpm
WE texture/redbrick.xpm
EA texture/wood.xpm

F 255,192,203
C 000,153,255

111111111111111111111
101110000000001111111
101111101111101110111
1000000S1111101110111
111111101111101110111
111111101111101110111
100000001110000000111
111111111111101111111
101011101010100000111
101110111111101111111
101010111010101110111
101010101010101010111
101010101010101010111
111111111111111111111
111110111111111110111
111110111111111110111
101010101010101010111
101010111111101110111
100000000000000000011
111111111111111111111
